{
  "walls": [
    " - - - - - - - - - - - ",
    "|               D2    D1",
    "   - -   - - -   - - - ",
    "|   |             |   |",
    "       - -   - -       ",
    "| |   |         |   | |",
    "   - -   - - -   - -   ",
    "| |                 | |",
    "     -   - - -   -     ",
    "| |   |         |   | |",
    "   -   - -   - -   -   ",
    "|                     |",
    "   - -     -     - -   ",
    "| |   | |     | |   | |",    
    "           -           ",
    "|   |   |     |   |   |",
    "     - -       - -     ",
    "| |       | |       | |",
    "   - -           - -   ",
    "|     | | | | | |     |",
    " D3                    ",
    "D4| |   | | | |   | | |",
    "     - -       - -     ",
    "| |     |     |     | |",
    "   - -   -   -   - -   ",
    "|     D5              |",
    " - - - - - - - - - - - "
   ],
  "doors": [ 
    {"direction":"W","special":"EnemyStart"},
    {"direction":"W"},
    {"direction":"S","levelStateRequired":"LevelEnd","special":"PlayerZoneEntrance"},
    {"direction":"E","special":"PlayerStart"},
    {"direction":"E","special":"PlayerZoneExit"},   
  ],
  "width": 11,
  "height": 13,
  "template": "outside11x13"
}